R 640 480
NO ./textures/wall_north.xpm   
SO ./textures/wall_south.xpm
WE ./textures/wall_west.xpm
EA ./textures/wall_east.xpm

S ./textures/ITEM.xpm
F 220,100,0
C 225,30,0
1 1 1  11 1 1 1 1 1 1 1 1 1 1 1 1 1 1 1 1 1 11111
1 0000 0001100000000000000001
11 10000111 00 0000200 000 10001
1010000 00000000E 0000001 0001
1110 000 1110 0000020 000010001
10 000 0001  1 0 0 0001110 11110001
1110111 1111101  1100000010001
1110 11111 1110111   01010010001
100000 01010101110000 0010001
10 00000 0 000  0 00110 00  00010001
1000 0000000 000  1101 010010001
1000 0001010101  11 110 1 1110 101
11101 111 1 1 0101 1111 01 1 110001
111111111111111 11111 1 1 11111
1111111 111111111111111 1  1111
