R 11640 880
NO ./textures/wall_north.xpm   
SO ./textures/wall_south.xpm
WE ./textures/wall_west.xpm
EA ./textures/wall_east.xpm
S ./textures/ITEM.xpm
F 00,153,15
C 255,255,255

111111111111
120002001001
10N100201001
101000000011
110000010001
100000001001
111101111111
111101111111
110000001011
100000000001
111111111111
