
11 1 1 1 1   1 1 1 1 1 1 1 1 1 1 1 1 1 1 1 11111
1 000000 0011000000000000001
101 10000111 0 000200 000 10001
10010000 0000000 0000001 0001
10110 000 1110 00020 000010001
100 0000 001  1   0001110 11110001
111101111 111101  10000010001
11110 11111 111011   1010010001
1100000 010101011100 0010001
100 00000 0 000  0 010 00  00010001
10000 0000000 000  11 010010001
11000 0011010101  11 1 1 1110 N01
111101 111 1 1 0101 11 01 1 110001
1111111111111111 111 1 1 11111
1111111 11111111111111 1  1111
R 640 480
NO ./textu r        es/wall_north.xpm   
SO ./textures/wall_south    .xpm
WE ./textures/wall_west.xp   m
S  ./textures/pillar.xpm
EA ./textures/wall_east.xpm

F 224,172,105
C 205,249,255
