R 640
NO ./textures/wall_north.xpm   
SO ./textures/wall_south.xpm
WE ./textures/wall_west.xpm
S  ./textures/pillar.xpm
EA ./textures/wall_east.xpm
F 00,153,15
C 255,255,255

111111111111111
120002000011001
10N100201111001
101000000000011
110000011110001
100000000011001
111101110011111
111101110011111
110000001101011
100000000000001
111111111111111
