
      R        800 800 
NO ./textu r        es/wall_north.xpm   
SO ./textures/wall_south    .xpm
WE ./textures/wall_west.xp   m
S  ./textures/pillar.xpm
EA ./textures/wall_east.xpm

F 224,172,105
C 205,249,255

111111111111111
120002000011001
10NI00201111001
100000000000011
110000011110001
100000000011001
111101110011111
111101110011111
110000001101011
100000000000001
111111111111111
